-+-----+----+++-----+----
---++-----+--++-----+-+--
--------+------+-+-----+-
---+-+----+----------+---
-----------+------+------
-----++------+----+------
--++--------+-----+----+-
-+------+----+------+----
-+----------+-+--+-+-++--
-+-+-------+---+--++----+
+-+++++--+------+--------
-+-+------+-----------+++
--++------+------------+-
-+-----+---+--++++-------
---+------+++-------+----
-----------------+---+-+-
-+---+-----+---+-----+---
-+--+-----+----+--+------
+------------+-----+-----
--+------------+---+-+--+
-++------+-----+---++---+
+-----+------+--+--+-----
--+--+-----------+-------
++---+--++++-+-----------
+---------------+-+---+++